############
############
############
############
.....#######
##.#.#######
##.#.#######
##.#.#######
##.#.#######
##...#######
############
############
